
NO ./assets/img/north.png
SO ./assets/img/south.png
WE ./assets/img/west.png
EA ./assets/img/east.png

F 77,140,85
C 148,231,247


        1111111111111111111111111
        1000000000110000000000001
        1011000001110000000000001
        100100000000000000000001
111111111011000001110000000000001
100000000011000001110111111111111
11110111111111011100000000001
11110111111111011101010000001
1100000011010101110111000001
10000000000000001101 10000001
10000000000000001101110000001
11000001110101011111011110W01
11110111 1110101 101111010001
11111111 1111111 111111111111
